10,8,
01,01,01,01,01,01,01,01,01,01,
01,01,00,00,00,SA,00,00,01,01,
01,01,00,00,00,00,00,00,01,01,
01,01,00,00,00,00,00,00,01,01,
01,01,00,SA,00,00,00,00,01,01,
01,00,00,00,00,00,00,00,00,01,
01,01,00,00,00,00,00,00,01,01,
01,01,01,01,01,01,01,01,01,01,